{
  "name": "Cueva Oscura",
  "mode": "ray",
  "width": 16,
  "height": 10,
  "tileSize": 64,
  "playerStart": { "x": 1.5, "y": 1.5, "dirX": 1, "dirY": 0 },
  "layers": {
    "cielo": { "type": "solid", "color": "#1a1a2e" },
    "terreno": [
      [1,1,1,1,1,1,1,1,1,1,1,1,1,1,1,1],
      [1,1,1,1,1,1,1,1,1,1,1,1,1,1,1,1],
      [1,1,1,1,1,1,1,1,1,1,1,1,1,1,1,1],
      [1,1,1,1,1,1,1,1,1,1,1,1,1,1,1,1],
      [1,1,1,1,1,1,1,1,1,1,1,1,1,1,1,1],
      [1,1,1,1,1,1,1,1,1,1,1,1,1,1,1,1],
      [1,1,1,1,1,1,1,1,1,1,1,1,1,1,1,1],
      [1,1,1,1,1,1,1,1,1,1,1,1,1,1,1,1],
      [1,1,1,1,1,1,1,1,1,1,1,1,1,1,1,1],
      [1,1,1,1,1,1,1,1,1,1,1,1,1,1,1,1]
    ],
    "mundo": [
      [2,2,2,2,2,2,2,2,2,2,2,2,2,2,2,2],
      [2,0,0,0,0,0,0,0,0,0,0,0,0,0,0,2],
      [2,0,0,0,0,0,0,0,0,0,0,0,0,0,0,2],
      [2,0,0,0,0,0,3,3,3,3,0,0,0,0,0,2],
      [2,0,0,0,0,0,3,0,0,3,0,0,0,0,0,2],
      [2,0,0,0,0,0,3,0,0,3,0,0,0,0,0,2],
      [2,0,0,0,0,0,3,0,3,3,0,0,0,0,0,2],
      [2,0,0,0,0,0,0,0,0,0,0,0,0,0,0,2],
      [2,0,0,0,0,0,0,0,0,0,0,0,0,0,0,2],
      [2,2,2,2,2,2,2,2,2,2,2,2,2,2,2,2]
    ],
    "personajes": [
      [0,0,0,0,0,0,0,0,0,0,0,0,0,0,0,0],
      [0,0,0,0,0,0,0,0,0,0,0,0,0,0,0,0],
      [0,0,0,0,0,0,0,0,0,0,0,0,0,0,0,0],
      [0,0,0,0,0,0,0,0,0,0,0,0,0,0,0,0],
      [0,0,0,0,0,0,0,0,0,0,0,0,0,0,0,0],
      [0,0,0,0,0,0,0,0,0,0,0,0,0,0,0,0],
      [0,0,0,0,0,0,0,0,0,0,0,0,0,0,0,0],
      [0,0,0,0,0,0,0,0,0,0,0,0,0,0,0,0],
      [0,0,0,0,0,0,0,0,0,0,0,0,0,0,0,0],
      [0,0,0,0,0,0,0,0,0,0,0,0,0,0,0,0]
    ],
    "eventos": [
      [0,0,0,0,0,0,0,0,0,0,0,0,0,0,0,0],
      [0,0,0,0,0,0,0,0,0,0,0,0,0,0,0,0],
      [0,0,0,0,0,0,0,0,0,0,0,0,0,0,0,0],
      [0,0,0,0,0,0,0,0,0,0,0,0,0,0,0,0],
      [0,0,0,0,0,0,0,0,0,0,0,0,0,0,0,0],
      [0,0,0,0,0,0,0,0,0,0,0,0,0,0,0,0],
      [0,0,0,0,0,0,0,0,0,0,0,0,0,0,0,0],
      [0,0,0,0,0,0,0,0,0,0,0,0,0,0,0,0],
      [0,0,0,0,0,0,0,0,0,0,0,0,0,0,0,0],
      [0,0,0,0,0,0,0,0,0,0,0,0,0,0,0,0]
    ]
  },
  "tileColors": {
    "1": { "color": "#1a1a2e", "name": "Suelo", "solid": false },
    "2": { "color": "#c97b3a", "name": "Pared roca", "solid": true },
    "3": { "color": "#6b4c8a", "name": "Pared magica", "solid": true }
  },
  "tileSprites": {
    "1": "pasto",
    "2": "pared_piedra",
    "3": "pared_piedra"
  },
  "exits": [
    { "tileX": 1, "tileY": 1, "target": "/maps/inicio.json", "spawnX": 23.5, "spawnY": 2.5, "label": "Salida del Bosque", "direction": "left", "locked": false, "keyId": null }
  ]
}
